 9   16
----------------
----------------
--------Z-------
---------S--X---
--Z------S--X---
---------S------
----XX---S------
------------YY--
------------YY--
